G75*
%MOIN*%
%OFA0B0*%
%FSLAX25Y25*%
%IPPOS*%
%LPD*%
%AMOC8*
5,1,8,0,0,1.08239X$1,22.5*
%
%ADD10C,0.05937*%
%ADD11R,0.07400X0.07400*%
%ADD12C,0.07400*%
%ADD13C,0.05906*%
%ADD14C,0.05000*%
D10*
X0155531Y0043500D02*
X0161469Y0043500D01*
X0161469Y0053500D02*
X0155531Y0053500D01*
X0155531Y0063500D02*
X0161469Y0063500D01*
X0161469Y0073500D02*
X0155531Y0073500D01*
X0155531Y0083500D02*
X0161469Y0083500D01*
X0161469Y0093500D02*
X0155531Y0093500D01*
X0155531Y0103500D02*
X0161469Y0103500D01*
X0161469Y0113500D02*
X0155531Y0113500D01*
X0155531Y0123500D02*
X0161469Y0123500D01*
X0161469Y0133500D02*
X0155531Y0133500D01*
X0155531Y0143500D02*
X0161469Y0143500D01*
X0161469Y0153500D02*
X0155531Y0153500D01*
X0155531Y0163500D02*
X0161469Y0163500D01*
X0161469Y0173500D02*
X0155531Y0173500D01*
X0155531Y0183500D02*
X0161469Y0183500D01*
X0161469Y0193500D02*
X0155531Y0193500D01*
X0155531Y0203500D02*
X0161469Y0203500D01*
X0161469Y0213500D02*
X0155531Y0213500D01*
X0155531Y0223500D02*
X0161469Y0223500D01*
X0161469Y0233500D02*
X0155531Y0233500D01*
X0245531Y0233500D02*
X0251469Y0233500D01*
X0251469Y0223500D02*
X0245531Y0223500D01*
X0245531Y0213500D02*
X0251469Y0213500D01*
X0251469Y0203500D02*
X0245531Y0203500D01*
X0245531Y0193500D02*
X0251469Y0193500D01*
X0251469Y0183500D02*
X0245531Y0183500D01*
X0245531Y0173500D02*
X0251469Y0173500D01*
X0251469Y0163500D02*
X0245531Y0163500D01*
X0245531Y0153500D02*
X0251469Y0153500D01*
X0251469Y0143500D02*
X0245531Y0143500D01*
X0245531Y0133500D02*
X0251469Y0133500D01*
X0251469Y0123500D02*
X0245531Y0123500D01*
X0245531Y0113500D02*
X0251469Y0113500D01*
X0251469Y0103500D02*
X0245531Y0103500D01*
X0245531Y0093500D02*
X0251469Y0093500D01*
X0251469Y0083500D02*
X0245531Y0083500D01*
X0245531Y0073500D02*
X0251469Y0073500D01*
X0251469Y0063500D02*
X0245531Y0063500D01*
X0245531Y0053500D02*
X0251469Y0053500D01*
X0251469Y0043500D02*
X0245531Y0043500D01*
D11*
X0218500Y0023500D03*
X0158500Y0023500D03*
D12*
X0038500Y0033500D03*
X0048500Y0033500D03*
X0058500Y0033500D03*
X0068500Y0033500D03*
X0138500Y0043500D03*
X0138500Y0053500D03*
X0138500Y0063500D03*
X0138500Y0093500D03*
X0168500Y0023500D03*
X0178500Y0023500D03*
X0188500Y0023500D03*
X0228500Y0023500D03*
X0238500Y0023500D03*
X0248500Y0023500D03*
X0273500Y0043500D03*
X0273500Y0053500D03*
X0273500Y0063500D03*
X0273500Y0073500D03*
X0273500Y0083500D03*
X0273500Y0093500D03*
X0273500Y0103500D03*
X0273500Y0113500D03*
X0283500Y0163500D03*
X0283500Y0173500D03*
X0283500Y0183500D03*
X0283500Y0193500D03*
X0283500Y0203500D03*
X0283500Y0213500D03*
X0283500Y0223500D03*
X0283500Y0233500D03*
X0388000Y0203500D03*
X0388000Y0193500D03*
X0388000Y0183500D03*
X0388000Y0173500D03*
X0353500Y0033500D03*
X0343500Y0033500D03*
X0333500Y0033500D03*
X0323500Y0033500D03*
X0028500Y0173500D03*
X0028500Y0183500D03*
X0028500Y0193500D03*
X0028500Y0203500D03*
D13*
X0078500Y0213500D03*
X0078500Y0163500D03*
X0078500Y0093500D03*
X0078500Y0063500D03*
X0313500Y0053500D03*
X0353500Y0053500D03*
X0328500Y0138500D03*
X0328500Y0198500D03*
D14*
X0328500Y0138500D01*
X0313500Y0053500D02*
X0353500Y0053500D01*
X0078500Y0063500D02*
X0078500Y0093500D01*
X0078500Y0163500D02*
X0078500Y0213500D01*
M02*
